# @author Jimmy O'Regan
# Based on material provided by Luis Villarejo, Universitat Oberta de Catalunya
alfíl=alfil
amít=amit
beisbòl=beisbol
cautxu=cautxú
cèltiber=celtiber
cèntigram=centigram
ciclòp=ciclop
Cistèr=Cister
críquet=criquet
elít=elit
filantròp=filantrop
fluòr=fluor
futbòl=futbol
handbòl=handbol
hàndicap=handicap
hèctogram=hectogram
hòquei=hoquei
ibèr=iber
ínterval=interval
lèvogir=levogir
línier=linier
míl·ligram=mil·ligram
mísantrop=misantrop
oboe=oboè
ovàl=oval
pelica=pelicà
pivot=pivot
pívot=pivot
polícrom=policrom
pòlicrom=policrom
políglot=poliglot
pòliglot=poliglot
quefír=quefir
radàr=radar
sahraui=sahrauí
sovièt=soviet
taiga=taigà
timpa=timpà
tiquèt=tiquet
tuàreg=tuareg
urdu=urdú
xandàll=xandall
xassis=xassís
zenít=zenit
Àdam=Adam
Artúr=Artur
Ausias=Ausiàs
Boris=Borís
Elísabet=Elisabet
Guifre=Guifré
Raímon=Raimon
Biarrítz=Biarritz
Carpàts=Carpats
Múnic=Munic
Tíbet=Tibet
Zúric=Zuric
àcne=acne
aerostat=aeròstat
almoravit=almoràvit
alveol=alvèol
anèmone=anemone
anglofob=anglòfob
apoplexía=apoplexia
astur=àstur
atmosfèra=atmosfera
augur=àugur
auríga=auriga
bantú=bantu
bíosfera=biosfera
bronquiol=bronquíol
centigrad=centígrad
cèntilitre=centilitre
cònclave=conclave
cònsola=consola
cotiledon=cotilèdon
dínamo=dinamo
endòsmosi=endosmosi
èpiclesi=epiclesi
èxegesi=exegesi
èxosmosi=exosmosi
gurú=guru
hèctolitre=hectolitre
hèmiplegia=hemiplegia
kàrate=karate
letàrgia=letargia
líbido=libido
ligur=lígur
mèdul·la=medul·la
megalit=megàlit
mil·lilitre=mil·lilitre
mímesi=mimesi
missil=míssil
nucleol=nuclèol
omoplat=omòplat
osmosi=osmosi
paraplegia=paraplegia
picnic=pícnic
poliester=polièster
prensil=prènsil
quadriga=quadriga
quilolitre=quilolitre
reostat=reòstat
reptil=rèptil
rupia=rupia
sicomor=sicòmor
sinergia=sinergia
termit=tèrmit
termostat=termòstat
textil=tèxtil
torticoli=torticoli
tulipa=tulipa
vacuol=vacúol
viking=víking
vimet=vímet
zoofit=zoòfit
zulú=zulu
Agamemnon=Agamèmnon
Aristídes=Aristides
Arquimèdes=Arquimedes
Astàrte=Astarte
Cerber=Cèrber
Ciriac=Ciríac
Didac=Dídac
Edip=Èdip
Eol=Èol
Esquil=Èsquil
Espartac=Espàrtac
Ganimèdes=Ganimedes
Herodot=Heròdot
Igor=Ígor
Jafet=Jàfet
Jason=Jàson
Karamazov=Karamàzov
Kefren=Kefren
Lacedemon=Lacedèmon
Vercingetorix=Vercingetòrix
Aneu=Àneu
Èfes=Efes
Eufràtes=Eufrates
Ilúro=Iluro
Kharkov=Khàrkov
Kiev=Kíev
Màli=Mali
Marraqueix=Marràqueix
Negueb=Nègueb
Ravenna=Ravenna
Samaria=Samaria
Sebastopol=Sebastòpol
Subur=Súbur
Tarent=Tàrent
Ucraina=Ucraïna
anode=ànode
antropofagia=antropofàgia
areola=arèola
aureola=aurèola
autolisi=autòlisi
catode=càtode
diode=díode
dioptria=diòptria
eczema=èczema
electrode=elèctrode
electrolisi=electròlisi
endospora=endòspora
enema=ènema
epode=èpode
especimen=espècimen
exospora=exòspora
gameta=gàmeta
isobara=isòbara
marqueting=màrqueting
metopa=mètopa
olimpiada=olimpíada
patxuli=pàtxuli
pentode=pèntode
periode=període
pneumonia=pneumònia
quadriceps=quàdriceps
rubeola=rubèola
tetrode=tètrode
triode=tríode
video=vídeo
zoospora=zoòspora
Artemis=Àrtemis
Astiages=Astíages
Atila=Àtila
Cibele=Cíbele
Damocles=Dàmocles
Esquines=Èsquines
Eumenes=Èumenes
Fafila=Fàfila
Favila=Fàvila
Heracles=Hèracles
Lascaris=Làscaris
Pericles=Pèricles
Praxiteles=Praxíteles
Proserpina=Prosèrpina
Sennaquerib=Sennàquerib
Setabis=Sètabis
Suintila=Suíntila
Ulfila=Úlfila
Vitiza=Vítiza
Barcino=Bàrcino
Bassora=Bàssora
Betulo=Bètulo
Brindisi=Bríndisi
Ecbatana=Ecbàtana
Egara=Ègara
Etiopia=Etiòpia
Helsinki=Hèlsinki
Himalaia=Himàlaia
Itaca=Ítaca
Katmandu=Kàtmandu
Ladoga=Làdoga
Larissa=Làrissa
Larnaca=Làrnaca
Megara=Mègara
Mikonos=Míkonos
Otranto=Òtranto
Sahara=Sàhara
Samosata=Samòsata
Sicoris=Sícoris
Tarraco=Tàrraco
Toquio=Tòquio
Umbria=Úmbria
