# @author Jimmy O'Regan
#
# Castellanismes 
#
# FIXME: Add full conjugation for verbs?
#
# FIMXE Multiwords... check Romanian?
# crucigrama=mots encreuats
# jabalí=porc senglar
# quiròfan=sala d'operacions
#
# FIXME: Needs its own rule:
# pues=doncs
# (pua, pues)
#

acera=vorera
aconteixement=esdeveniment
ajedrès=escacs
alemà=alemany
aleman=alemany
antes=abans
assunto=assumpte
averiguar=esbrinar
barco=vaixell
bueno=bé
carinyo=afecte
desaigüe=desguàs
después=després
disfrutar=gaudir
enfermetat=malaltia
enfermetats=malalties
entonses=aleshores
gasto=despesa
garantitzar=garantir
gelos=gelosia
hasta=fins
huelga=vaga
inglès=anglès
làmpara=làmpada
lavadora=rentadora
mantequilla=mantega
parxe=pegat
quadro=quadre
recado=encàrrec
reflexar=reflectir
sello=segell
sombra=ombra
tamany=mida
tonto=babau
urbano=urbà
verbena=revetlla
vivenda=habitatge
xarco=toll
# acronyms
máx=màx
cód=cod
admón=adm
dña=sra
